 1, u+0 ->  2, 'H', R
 2, u+0 ->  3, 'e', R
 3, u+0 ->  4, 'l', R
 4, u+0 ->  5, 'l', R
 5, u+0 ->  6, 'o', R
 6, u+0 ->  7, ',', R
 7, u+0 ->  8, ' ', R
 8, u+0 ->  9, 'W', R
 9, u+0 -> 10, 'o', R
10, u+0 -> 11, 'r', R
11, u+0 -> 12, 'l', R
12, u+0 -> 13, 'd', R
13, u+0 ->  0, '🌍', N